1111
1C01
1001
1P01
10E1
1111
