1111
1C01
1E01
1P01
1001
1111
