11111111111111111111
10000011100000000001
1000001E1000000C0001
100000000000P0000001
11111111111111111111